000000000000000000000000000000000000000000000000000000000000000000000000000000
000000000000000000000000000000000000000000000000000000000000000000000000000000
000000000000000000000000000000000000000000000000000000000000000000000000000000
000000000000000000000000000000000000000000000000000000000000000000000000000000
000000011111111111111111111111111111111110000000000000000000000000000000000000
000000000000000000001000000000000000000000000000000000000000000000000000000000
000000000000000000001000000000000000000000000000000000000000000000000000000001
000000000000000000001000000000000000000000000000000000000000000000000000000000
000000000000000000001000000000000000000000000000000001000000000000000000000000
000000000000000000001000000000000000000000001111111101000000000000000000000000
000000000000000000001000000000000000000000001000000001000000000000000000000000
000000000000000000001000000000000000000000001000000001000000000000000000000000
000000000000000000001000000000000000000000001000000001000000000000000000000000
000000000000000000001000000000000000000000001000000001000000000000000000000000
000000000000000000001111111111111111111111111000000001000000000000000000000000
000000000000000000000000000000000000000000000000000000000000000000000000000000
000000000000000000000000000000000000000000000000000000000000000000000000000000
000000000000000000000000000000000000000000000000000000000000000000000000000000
000000000000000000000000000000000000000000000000000000000000000000000000000000
000000000000000000000000000000000000000000000000000000000000000000000000000000
000000000000000000000000000000000000000000000000000000000000000000000000000000
