000000000000000000000000000000000000000000000000000000000000000000000000000000
000000000000000000000000000000000000000000000000000000000000000000000000000000
000000000000000000000000000000000000000000000000000000000000000000000000000000
000000000000000000000000000000000000010000000000000000000000000000000000000000
000000000000000000000000000000000000010000000000000000000000000000000000000000
000000000000000000000000000000000000010000000000000000000000000000000000000000
000000000000000000000000000000000000010000000000000000000000000000000000000000
000000000000000000000000000000000000010000000000000000000000000000000000000000
000000000000000000000000000000000000010000000000000000000000000000000000000000
000000000000000000000000000000000000010000000000000000000000000000000000000000
000111111111111111111111111111111111111111111111111111111111111111111111111000
000000000000000000000000000000000000010000000000000000000000000000000000000000
000000000000000000000000000000000000010000000000000000000000000000000000000000
000000000000000000000000000000000000010000000000000000000000000000000000000000
000000000000000000000000000000000000010000000000000000000000000000000000000000
000000000000000000000000000000000000010000000000000000000000000000000000000000
000000000000000000000000000000000000010000000000000000000000000000000000000000
000000000000000000000000000000000000010000000000000000000000000000000000000000
000000000000000000000000000000000000000000000000000000000000000000000000000000
000000000000000000000000000000000000000000000000000000000000000000000000000000
000000000000000000000000000000000000000000000000000000000000000000000000000000
