000000000000000000000000000000000000000000000000000000000000000000000000000000
000000000000000000000000000000000000000000000000000000000000000000000000000000
111111111111111111111111111111111111111111111111111111111111111111111111111100
000000000000000000000000000000000000000000000000000000000000000000000000000000
000000000000000000000000000000000000000000000000000000000000000000000000000000
001111111111111111111111111111111111111111111111111111111111111111111111111111
001000001000000000000000000000000001000001000000000000000000000000000000000000
001000001000000000000000000000000001000001000000000000000000000000000000000000
001001001001111111111111111111111001001001001111111111111111111111111111111100
001001001001001000001000001000001001001001001000000000000000000000000000000000
001001001001001000001000001000001001001001001000000000000000000000000000000000
001001001001001001001001001001001001001001001001111111111111111111111111111111
001001001001001001001001001001001001001001001000000000000000000000000000000000
001001001001001001001001001001001001001001001000000000000000000000000000000000
001001001001001001001001001001001001001001001111111111111111111111111111111100
001001001001001001001001001001001001001001001000000100000100000100000100000100
001001001001000001000001000001000001001001001000000100000100000100000100000100
001001001001000001000001000001000001001001001000100100100100100100100100100100
001001001001001111111111111111111111001001001100100100100100100100100100100100
000001000001000000000000000000000000001000001000100000100000100000100000100000
000001000001000000000000000000000000001000001000100000100000100000100000100000
