000000000000000000000000000000000000000000000010000000000000111111111000000000
000001000000000000000000000100000001000000000000000000000000000000000100000000
000001111111110000000000000111111111111111111111111111111110000000000010000000
000001000000000000000000000100000000000000000000000000000000000000000001000000
000001000011111111111111111100000000000000000000001000000000000000000000100000
000001000010000000000001000000000000000000000000001000000000000000000000010000
000001000010111111111101001111111111111111111000001000011111111111100000001000
000000000010100000000001000000000000000000000000001000000000000000000000000000
111100001010101111111111000000000000011111111111111111111111111111111110000000
000000000000000000000000000000000000000000000000000000000010000000000000000000
000100000000000000000000000000000000000000000000000000000010000000000000000000
000100000000100000000100000001111111111111111000000000000010011111111111110000
000100000000100000000100000000000000000000000000000000000000000000000001000000
000100000000100000000100000000000000000000000000000000000000000000000001000000
000100000111111111111111111111111111111111110111111111111111111111110001000000
000100000010000000000000000000100000000000000000000000000000000000000001000000
000100000010000000000000000000100000000000000000010000000010000000000001000000
000100000010000000000000000000111111111011111111110000000010000000000001000000
000100111111111111110000000000100000000000000000011111111010000000000001000000
000000000000000000000000000000000000000000000000000000000000000000000000000000
000000000000000000000000000000000000000000000000000000000000000000000000000000
