000000000000000000000000000000000000000000000000000000000000000000000000000000
000000000000000000000000000000000000010000000000000000000000000000000000000000
000000000000000000000000000000000000010000000000000000000000000000000000000000
000000000000000000000000000000000000010000000000000000000000000000000000000000
000000000000000010011111111111111111111111111111111111111110010000000000000000
000000000000000010000000000000000000010000000000000000000000010000000000000000
000000000000000010000000000000000000010000000000000000000000010000000000000000
000000000000000010000000000000000000010000000000000000000000010000000000000000
000000000000000010000000000000000000000000000000000000000000010000000000000000
000000000000000010000000000000000000000000000000000000000000010000000000000000
011111111111111111111111111111111110000011111111111111111111111111111111111110
000000000000000010000000000000000000000000000000000000000000010000000000000000
000000000000000010000000000000000000000000000000000000000000010000000000000000
000000000000000010000000000000000000010000000000000000000000010000000000000000
000000000000000010000000000000000000010000000000000000000000010000000000000000
000000000000000010000000000000000000010000000000000000000000010000000000000000
000000000000000010011111111111111111111111111111111111111110010000000000000000
000000000000000000000000000000000000010000000000000000000000000000000000000000
000000000000000000000000000000000000010000000000000000000000000000000000000000
000000000000000000000000000000000000010000000000000000000000000000000000000000
000000000000000000000000000000000000000000000000000000000000000000000000000000
